"filename", "language", "JSON", "CSV", "Markdown", "Java", "comment", "blank", "total"
"d:\DevelopCode\CPP\algorithm\算法竞赛\.VSCodeCounter\2024-06-20_00-08-48\details.md", "Markdown", 0, 0, 202, 0, 0, 6, 208
"d:\DevelopCode\CPP\algorithm\算法竞赛\.VSCodeCounter\2024-06-20_00-08-48\diff-details.md", "Markdown", 0, 0, 9, 0, 0, 6, 15
"d:\DevelopCode\CPP\algorithm\算法竞赛\.VSCodeCounter\2024-06-20_00-08-48\diff.csv", "CSV", 0, 2, 0, 0, 0, 0, 2
"d:\DevelopCode\CPP\algorithm\算法竞赛\.VSCodeCounter\2024-06-20_00-08-48\diff.md", "Markdown", 0, 0, 12, 0, 0, 7, 19
"d:\DevelopCode\CPP\algorithm\算法竞赛\.VSCodeCounter\2024-06-20_00-08-48\results.csv", "CSV", 0, 195, 0, 0, 0, 0, 195
"d:\DevelopCode\CPP\algorithm\算法竞赛\.VSCodeCounter\2024-06-20_00-08-48\results.json", "JSON", 1, 0, 0, 0, 0, 0, 1
"d:\DevelopCode\CPP\algorithm\算法竞赛\.VSCodeCounter\2024-06-20_00-08-48\results.md", "Markdown", 0, 0, 84, 0, 0, 7, 91
"d:\DevelopCode\CPP\algorithm\算法竞赛\大一下\Java\PTA3\7-6 jmu-Java&Python-统计文字中的单词数量并按出现次数排序\Main.java", "Java", 0, 0, 0, 29, 0, 4, 33
"d:\DevelopCode\CPP\algorithm\算法竞赛\大一下\Java\PTA3\7-7 JAVA-求整数序列中出现次数最多的数\Main.java", "Java", 0, 0, 0, 26, 0, 1, 27
"d:\DevelopCode\CPP\algorithm\算法竞赛\大一下\Java\PTA3\7-8 字符串分割拼接\Main.java", "Java", 0, 0, 0, 2, 0, 2, 4
"d:\DevelopCode\CPP\algorithm\算法竞赛\大一下\Java\PTA4\7-2 sdut-Map-Sort--C~K的班级（III）\Main.java", "Java", 0, 0, 0, 61, 0, 9, 70
"d:\DevelopCode\CPP\algorithm\算法竞赛\大一下\Java\PTA4\7-3 jmu-Java-06异常-01-常见异常\Main.java", "Java", 0, 0, 0, 33, 0, 1, 34
"d:\DevelopCode\CPP\algorithm\算法竞赛\大一下\Java\PTA4\7-4 jmu-Java-06异常-02-使用异常机制处理异常输入\Main.java", "Java", 0, 0, 0, 20, 0, 1, 21
"d:\DevelopCode\CPP\algorithm\算法竞赛\大一下\Java\PTA4\7-7 sdut-String-2 识蛟龙号载人深潜，立科技报国志（2）（正则表达式）\Main.java", "Java", 0, 0, 0, 21, 0, 1, 22
"d:\DevelopCode\CPP\algorithm\算法竞赛\大一下\Java\PTA4\7-8 sdut-oop-7 答答租车系统（类的继承与多态 面向对象综合练习）\Main.java", "Java", 0, 0, 0, 84, 0, 14, 98
"Total", "-", 1, 197, 307, 276, 0, 59, 840